40 40 300 70
----||||||||||||||||||||||||||||||||||--
----||||||||||||||||||||||||||||||||||--
----||||||||||||||||||||||||||||||||||--
----||||||||||||||||-|||||||||||||||||--
----||||||||||||||||--||||||||||||||||--
----|||||||||||||||----|||||||||||||||--
----||||||||||||||--------||||||||||||--
----||||||||||||------------||||||||||--
----||||||||||||------------||||||||||--
----||||||||||||------------||||||||||--
----||||||||||||------------||||||||||--
----||||||||||||------------||||||||||--
----||||||||||||------------||||||||||--
----||||||||||||------------||||||||||--
----||||||||||||------------||||||||||--
----||||||||||||------------||||||||||--
----||||||||||||------------||||||||||--
----||||||||||||------------||||||||||--
----||||||||||||||||||||||||||||||||||--
----||||||||||||||||||||||||||||||||||--
----||||||||||||||||||||||||||||||||||--
----||||||||||||||||||||||||||||||||||--
----||||||||||||||||||||||||||||||||||--
----||||||||||||||||||||||||||||||||||--
----||||||||||||||||||||||||||||||||||--
----||||||||||||||||||||||||||||||||||--
----||||||||||||||||||||||||||||||||||--
----||||||||||||||||||||||||||||||||||--
----||||||||||||||||||||||||||||||||||--
----|||||||||||||||||------|||||||||||--
----||||||||||||------------||||||||||--
----||||||||||||------------||||||||||--
----||||||||||||------------||||||||||--
----||||||||||||------------||||||||||--
----||||||||||||------------||||||||||--
----||||||||||||------------||||||||||--
----||||||||||||------||||||||||||||||--
----||||||||||||||||||||||||||||||||||--
----||||||||||||||||||||||||||||||||||--
----||||||||||||||||||||||||||||||||||--