40 40 36 80
-----|||||||||||||||||||||||||||||||||||||||||||||||||------
-----|||||||||||||||||||||||||||||||||||||||||||||||||------
-----|||||||||||||||||||||||||||||||||||||||||||||||||------
-----|||||||||||||||||||||||||||||||||||||||||||||||||------
-----|||||||||||||||||||||||||||||||||||||||||||||||||------
-----|||||||||||||||||||||||||||||||||||||||||||||||||------
-----|||||||||||||||||||||||||||||||||||||||||||||||||------
-----|||||||||||||||||||||||||||||||||||||||||||||||||------
-----|||||||||||||||||||||||||||||||||||||||||||||||||------
-----|||||||||||||||||||||||||||||||||||||||||||||||||------
-----|||||||||||||||||||||||||||||||||||||||||||||||||------
-----|||||||||||||||||||||||||||||||||||||||||||||||||------
-----|||||||||||||||||||||||||||||||||||||||||||||||||------
-----|||||||||||||||||||||||||||||||||||||||||||||||||------
-----|||||||||||||||||||||||||||||||||||||||||||||||||------
-----||||||||||||||||||||||--|||||||||||||||||||||||||------
-----|||||||||||||||||||--------||||||||||||||||||||||------
-----||||||||||||||--------------------|||||||||||||||------
-----|||||||----------------------------------||||||||------
-----|||||||-----------------------------------|||||||------
-----|||||||-----------------------------------|||||||------
-----|||||||-----------------------------------|||||||------
-----|||||||-----------------------------------|||||||------
-----|||||||----------------------------------||||||||------
-----|||||||-----------------------------------|||||||------
-----|||||||-----------------------------------|||||||------
-----|||||||-----------------------------------|||||||------
-----|||||||-----------------------------------|||||||------
-----|||||||||----------------------------||||||||||||------
-----|||||||||||------------------------||||||||||||||------
-----|||||||||||||||||------------||||||||||||||||||||------
-----||||||||||||||||||||||----|||||||||||||||||||||||------
-----|||||||||||||||||||||||||||||||||||||||||||||||||------
-----|||||||||||||||||||||||||||||||||||||||||||||||||------
-----|||||||||||||||||||||||||||||||||||||||||||||||||------
-----|||||||||||||||||||||||||||||||||||||||||||||||||------
-----|||||||||||||||||||||||||||||||||||||||||||||||||------
-----|||||||||||||||||||||||||||||||||||||||||||||||||------
-----|||||||||||||||||||||||||||||||||||||||||||||||||------
-----|||||||||||||||||||||||||||||||||||||||||||||||||------
-----|||||||||||||||||||||||||||||||||||||||||||||||||------
-----|||||||||||||||||||||||||||||||||||||||||||||||||------
-----|||||||||||||||||||||||||||||||||||||||||||||||||------
-----|||||||||||||||||||||||||||||||||||||||||||||||||------
-----|||||||||||||||||||||||||||||||||||||||||||||||||------
-----|||||||||||||||||||||||||||||||||||||||||||||||||------
-----|||||||||||||||||||||||||||||||||||||||||||||||||------
-----|||||||||||||||||||||||||||||||||||||||||||||||||------
-----|||||||||||||||||||||||||||||||||||||||||||||||||------
-----|||||||||||||||||||||||||||||||||||||||||||||||||------
-----|||||||||||||||||||||||||||||||||||||||||||||||||------
-----|||||||||||||||||||||||||||||||||||||||||||||||||------
-----|||||||||||||||||||||||||||||||||||||||||||||||||------
-----|||||||||||||||||||||||||||||||||||||||||||||||||------
-----|||||||||||||||||||||||||||||||||||||||||||||||||------
-----|||||||||||||||||||||||||||||||||||||||||||||||||------
-----|||||||||||||||||||||||||||||||||||||||||||||||||------
-----|||||||||||||||||||||||||||||||||||||||||||||||||------
-----|||||||||||||||||||||||||||||||||||||||||||||||||------
-----|||||||||||||||||||||||||||||||||||||||||||||||||------